20 14 32
11111111111111111111
12000000011000000021
10111111000011111101
10111111100111111101
10000000000000000001
10111011011011011101
10111011011011211101
10111011211011011101
10111011011011011101
10000000000000000001
10111111100111111101
10111111000011111101
12000000011000000021
11111111111111111111